"ax" = (/obj/effect/spawner/structure/window/reinforced,/obj/machinery/door/firedoor,/turf/open/floor/plating,/area/hallway/secondary/entry)
"aJ" = (/obj/docking_port/stationary{dir = 2; dwidth = 1; height = 4; name = "escape pod loader"; roundstart_template = /datum/map_template/shuttle/escape_pod/default; width = 3},/turf/open/space/basic,/area/space)
"bE" = (/obj/structure/closet/emcloset,/turf/open/floor/plasteel,/area/hallway/secondary/exit/departure_lounge)
"cD" = (/obj/machinery/atmospherics/pipe/simple/supply/hidden{dir = 9},/turf/open/floor/plasteel,/area/hallway/secondary/exit/departure_lounge)
"cZ" = (/obj/machinery/atmospherics/pipe/simple/scrubbers/hidden,/turf/open/floor/plasteel,/area/hallway/secondary/exit/departure_lounge)
"er" = (/obj/machinery/vending/cola/random,/turf/open/floor/plasteel,/area/hallway/secondary/exit/departure_lounge)
"ez" = (/obj/effect/spawner/structure/window/hollow/plasma/reinforced/directional{dir = 8},/obj/effect/spawner/structure/window/hollow/plasma/reinforced/directional{dir = 1},/turf/open/floor/grass,/area/hallway/secondary/exit/departure_lounge)
"fG" = (/obj/structure/chair{dir = 8},/turf/open/floor/plasteel,/area/hallway/secondary/exit/departure_lounge)
"go" = (/obj/effect/spawner/structure/window/reinforced,/obj/machinery/door/firedoor,/turf/open/floor/plating,/area/hallway/secondary/exit/departure_lounge)
"hk" = (/turf/closed/wall,/area/hallway/secondary/entry)
"hD" = (/obj/structure/chair/comfy{dir = 8},/obj/machinery/atmospherics/pipe/simple/scrubbers/hidden,/turf/open/floor/plasteel,/area/hallway/secondary/exit/departure_lounge)
"jn" = (/obj/effect/spawner/structure/window/hollow/plasma/reinforced/directional,/obj/effect/spawner/structure/window/hollow/plasma/reinforced/directional{dir = 8},/turf/open/floor/grass,/area/hallway/secondary/exit/departure_lounge)
"jJ" = (/obj/docking_port/stationary{dir = 2; dwidth = 3; height = 15; id = "arrivals_stationary"; name = "arrivals"; roundstart_template = /datum/map_template/shuttle/arrival/box; width = 7},/turf/open/space/basic,/area/space)
"jZ" = (/obj/machinery/door/airlock/external{name = "Escape Airlock"},/obj/effect/mapping_helpers/airlock/cyclelink_helper,/obj/machinery/door/firedoor,/turf/open/floor/plating,/area/hallway/secondary/exit/departure_lounge)
"kh" = (/obj/effect/spawner/structure/window/reinforced,/turf/open/floor/plating,/area/hallway/secondary/exit/departure_lounge)
"kl" = (/obj/docking_port/stationary{dir = 2; dwidth = 12; height = 18; id = "emergency_home"; name = "BoxStation emergency evac bay"; width = 32},/turf/open/space/basic,/area/space)
"kF" = (/obj/structure/chair/comfy{dir = 4},/turf/open/floor/plasteel,/area/hallway/secondary/exit/departure_lounge)
"lc" = (/turf/closed/wall/r_wall,/area/hallway/secondary/exit/departure_lounge)
"lm" = (/turf/open/floor/plasteel,/area/hallway/secondary/entry)
"lq" = (/obj/machinery/atmospherics/pipe/manifold/supply/hidden{dir = 8},/turf/open/floor/plasteel,/area/hallway/secondary/exit/departure_lounge)
"mg" = (/obj/structure/closet/emcloset,/turf/open/floor/plasteel,/area/hallway/secondary/entry)
"mK" = (/obj/machinery/door/firedoor/heavy,/turf/open/floor/plasteel,/area/hallway/secondary/exit/departure_lounge)
"nx" = (/obj/effect/spawner/structure/window/hollow/plasma/reinforced/directional{dir = 1},/obj/effect/spawner/structure/window/hollow/plasma/reinforced/directional{dir = 4},/turf/open/floor/grass,/area/hallway/secondary/exit/departure_lounge)
"nR" = (/turf/template_noop,/area/template_noop)
"oe" = (/obj/machinery/atmospherics/components/unary/vent_scrubber/on{dir = 8},/turf/open/floor/plasteel,/area/hallway/secondary/exit/departure_lounge)
"om" = (/obj/docking_port/stationary/random{dir = 2; id = "pod_lavaland1"; name = "lavaland"},/turf/open/space/basic,/area/space)
"ov" = (/obj/machinery/atmospherics/components/unary/vent_scrubber/on{dir = 1},/turf/open/floor/plasteel,/area/hallway/secondary/exit/departure_lounge)
"po" = (/obj/machinery/atmospherics/pipe/simple/supply/hidden{dir = 5},/turf/open/floor/plasteel,/area/hallway/secondary/exit/departure_lounge)
"pN" = (/obj/machinery/atmospherics/pipe/simple/scrubbers/hidden,/obj/machinery/door/firedoor/heavy,/turf/open/floor/plasteel,/area/hallway/secondary/exit/departure_lounge)
"qo" = (/obj/machinery/atmospherics/pipe/simple/supply/hidden,/obj/machinery/door/firedoor/heavy,/turf/open/floor/plasteel,/area/hallway/secondary/exit/departure_lounge)
"qr" = (/obj/structure/disposalpipe/segment,/turf/closed/wall,/area/hallway/secondary/exit/departure_lounge)
"rh" = (/obj/machinery/door/airlock/command{name = "Emergency Escape"; req_access_txt = "20"},/obj/structure/plasticflaps/opaque,/turf/open/floor/engine,/area/hallway/secondary/exit/departure_lounge)
"tj" = (/obj/machinery/atmospherics/pipe/simple/supply/hidden,/obj/machinery/door/firedoor/heavy,/turf/open/floor/plasteel,/area/hallway/secondary/entry)
"uH" = (/obj/machinery/door/firedoor/heavy,/turf/open/floor/plasteel,/area/hallway/secondary/entry)
"uT" = (/turf/open/space/basic,/area/space)
"vF" = (/obj/machinery/vending/snack/random,/turf/open/floor/plasteel,/area/hallway/secondary/entry)
"vU" = (/turf/open/floor/plasteel,/area/hallway/secondary/exit/departure_lounge)
"wD" = (/obj/machinery/door/airlock/external{name = "Security Escape Airlock"; req_access_txt = "2"},/obj/effect/mapping_helpers/airlock/cyclelink_helper{dir = 1},/turf/open/floor/plating,/area/hallway/secondary/exit/departure_lounge)
"wJ" = (/obj/structure/chair/comfy{dir = 4},/obj/machinery/atmospherics/pipe/simple/supply/hidden,/turf/open/floor/plasteel,/area/hallway/secondary/exit/departure_lounge)
"wO" = (/obj/machinery/atmospherics/pipe/simple/supply/hidden,/turf/open/floor/plasteel,/area/hallway/secondary/entry)
"xz" = (/turf/open/space/basic,/area/space/nearstation)
"zc" = (/obj/machinery/door/airlock/external{name = "Security Escape Airlock"; req_access_txt = "2"},/obj/effect/mapping_helpers/airlock/cyclelink_helper,/obj/machinery/door/firedoor,/turf/open/floor/plating,/area/hallway/secondary/exit/departure_lounge)
"zl" = (/obj/structure/table,/obj/machinery/atmospherics/pipe/simple/supply/hidden,/turf/open/floor/plasteel,/area/hallway/secondary/exit/departure_lounge)
"zU" = (/obj/machinery/atmospherics/pipe/simple/scrubbers/hidden{dir = 4},/turf/open/floor/plasteel,/area/hallway/secondary/exit/departure_lounge)
"AQ" = (/obj/machinery/vending/snack/random,/turf/open/floor/plasteel,/area/hallway/secondary/exit/departure_lounge)
"BA" = (/obj/machinery/atmospherics/components/unary/vent_pump/on{dir = 8},/turf/open/floor/plasteel,/area/hallway/secondary/exit/departure_lounge)
"Cp" = (/obj/structure/chair/comfy{dir = 4},/obj/machinery/atmospherics/pipe/manifold/supply/hidden{dir = 4},/turf/open/floor/plasteel,/area/hallway/secondary/exit/departure_lounge)
"Ee" = (/obj/machinery/door/airlock/security/glass{name = "Holding Area"; req_access_txt = "2"},/obj/machinery/atmospherics/pipe/simple/scrubbers/hidden,/turf/open/floor/plasteel,/area/hallway/secondary/exit/departure_lounge)
"EG" = (/obj/effect/spawner/structure/window/hollow/plasma/reinforced/directional{dir = 4},/turf/open/floor/grass,/area/hallway/secondary/exit/departure_lounge)
"Gi" = (/obj/machinery/atmospherics/pipe/simple/scrubbers/hidden,/turf/open/floor/plasteel,/area/hallway/secondary/entry)
"Gk" = (/obj/structure/table,/turf/open/floor/plasteel,/area/hallway/secondary/exit/departure_lounge)
"Hv" = (/obj/effect/spawner/structure/window/hollow/plasma/reinforced/directional,/turf/open/floor/grass,/area/hallway/secondary/exit/departure_lounge)
"HK" = (/obj/machinery/atmospherics/pipe/manifold/scrubbers/hidden{dir = 1},/turf/open/floor/plasteel,/area/hallway/secondary/exit/departure_lounge)
"HS" = (/obj/machinery/airalarm{pixel_y = 24},/obj/structure/disposalpipe/trunk{dir = 1},/obj/machinery/disposal/bin,/turf/open/floor/plasteel,/area/hallway/secondary/exit/departure_lounge)
"Ij" = (/obj/effect/spawner/structure/window/reinforced,/turf/open/floor/plating,/area/hallway/secondary/entry)
"IJ" = (/turf/closed/wall/r_wall,/area/hallway/secondary/entry)
"Jg" = (/obj/machinery/door/airlock/external{name = "Port Docking Bay 1"},/obj/effect/mapping_helpers/airlock/cyclelink_helper{dir = 8},/turf/open/floor/plating,/area/hallway/secondary/entry)
"Lm" = (/obj/machinery/atmospherics/pipe/simple/scrubbers/hidden,/obj/machinery/door/firedoor/heavy,/turf/open/floor/plasteel,/area/hallway/secondary/entry)
"LP" = (/obj/machinery/atmospherics/pipe/manifold/scrubbers/hidden{dir = 8},/turf/open/floor/plasteel,/area/hallway/secondary/exit/departure_lounge)
"Mc" = (/obj/machinery/atmospherics/pipe/simple/supply/hidden{dir = 4},/turf/open/floor/plasteel,/area/hallway/secondary/exit/departure_lounge)
"Mt" = (/obj/effect/mapping_helpers/airlock/cyclelink_helper{dir = 1},/obj/machinery/door/airlock/external{name = "Escape Pod One"},/turf/open/floor/plating,/area/hallway/secondary/entry)
"MJ" = (/obj/effect/mapping_helpers/airlock/cyclelink_helper,/obj/machinery/door/airlock/external{name = "Escape Pod One"},/obj/machinery/door/firedoor,/turf/open/floor/plating,/area/hallway/secondary/entry)
"MX" = (/obj/machinery/computer/arcade,/turf/open/floor/plasteel,/area/hallway/secondary/exit/departure_lounge)
"OJ" = (/obj/structure/chair/comfy{dir = 8},/obj/machinery/atmospherics/pipe/simple/supply/hidden{dir = 4},/obj/machinery/atmospherics/pipe/simple/scrubbers/hidden,/turf/open/floor/plasteel,/area/hallway/secondary/exit/departure_lounge)
"PQ" = (/obj/machinery/atmospherics/pipe/simple/supply/hidden{dir = 6},/turf/open/floor/plasteel,/area/hallway/secondary/exit/departure_lounge)
"PW" = (/obj/machinery/quantumpad{map_pad_id = "Evac"; map_pad_link_id = "EvacBridge"},/turf/open/floor/engine,/area/hallway/secondary/exit/departure_lounge)
"Qq" = (/obj/machinery/door/firedoor,/turf/open/floor/plating,/area/hallway/secondary/entry)
"QT" = (/obj/structure/table,/obj/machinery/atmospherics/pipe/simple/scrubbers/hidden,/turf/open/floor/plasteel,/area/hallway/secondary/exit/departure_lounge)
"SW" = (/obj/structure/lattice,/turf/open/space/basic,/area/space/nearstation)
"TS" = (/obj/machinery/atmospherics/pipe/manifold/supply/hidden{dir = 8},/turf/open/floor/plasteel,/area/hallway/secondary/entry)
"Vb" = (/obj/machinery/atmospherics/pipe/simple/supply/hidden,/turf/open/floor/plasteel,/area/hallway/secondary/exit/departure_lounge)
"WD" = (/obj/structure/closet/emcloset,/turf/open/floor/plating,/area/hallway/secondary/entry)
"WF" = (/obj/machinery/atmospherics/pipe/simple/supply/hidden{dir = 4},/turf/closed/wall,/area/hallway/secondary/exit/departure_lounge)
"WH" = (/turf/open/floor/plating,/area/hallway/secondary/entry)
"Xr" = (/obj/machinery/atmospherics/components/unary/vent_scrubber/on{dir = 1},/turf/open/floor/plasteel,/area/hallway/secondary/entry)
"Yc" = (/obj/effect/spawner/structure/window/hollow/plasma/reinforced/directional,/obj/effect/spawner/structure/window/hollow/plasma/reinforced/directional{dir = 4},/turf/open/floor/grass,/area/hallway/secondary/exit/departure_lounge)
"Yn" = (/turf/open/floor/plating,/area/hallway/secondary/exit/departure_lounge)
"Yq" = (/turf/closed/wall,/area/hallway/secondary/exit/departure_lounge)
"Yv" = (/obj/effect/spawner/structure/window/hollow/plasma/reinforced/directional{dir = 8},/turf/open/floor/grass,/area/hallway/secondary/exit/departure_lounge)
"Yy" = (/mob/living/simple_animal/pet/redpanda{desc = "This is a normal Ailurus fulgens, which, and all of NT researchers can agree on this, never vore."; flavor_text = "This is a normal Ailurus fulgens, which, and all of NT researchers can agree on this, never vore."; health = 2000; name = "Chase the Red panda"},/turf/open/floor/grass,/area/hallway/secondary/exit/departure_lounge)
"YM" = (/obj/machinery/atmospherics/components/unary/vent_pump/on{dir = 8},/obj/machinery/atmospherics/pipe/simple/scrubbers/hidden,/turf/open/floor/plasteel,/area/hallway/secondary/entry)
"YO" = (/obj/machinery/atmospherics/components/unary/vent_pump/on{dir = 1},/turf/open/floor/plasteel,/area/hallway/secondary/entry)
"Zm" = (/obj/machinery/door/airlock/external{name = "Port Docking Bay 1"},/obj/effect/mapping_helpers/airlock/cyclelink_helper{dir = 4},/turf/open/floor/plating,/area/hallway/secondary/entry)
"ZG" = (/obj/effect/spawner/structure/window/hollow/plasma/reinforced/directional{dir = 1},/turf/open/floor/grass,/area/hallway/secondary/exit/departure_lounge)
"ZI" = (/obj/machinery/door/airlock/external{name = "Escape Airlock"},/obj/effect/mapping_helpers/airlock/cyclelink_helper{dir = 1},/turf/open/floor/plating,/area/hallway/secondary/exit/departure_lounge)
"ZO" = (/obj/item/beacon,/turf/open/floor/plasteel,/area/hallway/secondary/entry)

(1,1,1) = {"
nRnRnRnRnRnRnRnRnRnRnRnRnRnRnRnRnRnRnRnRnRnRnRnRnRnRnRnRnRnRlclclc
nRnRnRnRnRnRnRnRnRnRnRnRnRnRnRnRnRnRnRnRnRnRnRnRnRnRnRnRnRnRlcPWlc
IJIJIJIJaxaxaxaxaxIJIJIJuHtjLmIJqomKpNYqYqYqYqYqYqqrYqYqYqYqlcrhlc
lmaxxzuTuTuTjJuTuTuTxzaxlmwOGiIJVbvUcZvUAQerAQerAQHSbEbEbEMXMXvUlc
IjaxIjuTuTuTuTuTuTuTIjaxIjwOGiIJVbvUcZvUvUvUvUvUvUvUvUvUvUvUvUvUlc
ZmQqJguTuTuTuTuTuTuTZmQqJgwOGiIJVbvULPzUzUzUzUHKzUzUzUHKoevUvUvUlc
IjaxIjuTuTuTuTuTuTuTIjaxIjTSYMIJlqBALPoevUPQBALPoePQBAcZezZGnxvUlc
vFaxxzuTuTuTuTuTuTuTxzaxmgwOGiIJVbvUhDYqkFlqMcOJWFCpvUcZYvYyEGvUlc
lmaxxzuTuTuTuTuTuTuTxzaxmgwOGiIJVbvUQTYqGkVbvUQTYqzlvUcZjnHvYcvUlc
mgaxxzuTuTuTuTuTuTuTxzaxZOwOGiIJVbvUhDYqkFVbvUhDYqwJvUcZvUvUvUvUlc
mgaxxzuTuTuTuTuTuTuTxzaxvFwOGiIJVbvUhDYqkFVbvUhDYqwJvUcZkhkhkhkhlc
IjaxIjuTuTuTuTuTuTuTIjaxIjwOGiIJVbvUQTYqGkVbvUQTYqzlvUcZkhvUvUfGlc
ZmQqJguTuTuTuTuTuTuTZmQqJgYOXrIJVbvUhDYqkFVbvUhDYqwJvUcZEevUvUfGlc
IjaxIjuTuTuTuTuTuTuTIjaxIjlmlmIJlqBAovvUvUlqBAovvUpoBAovkhvUvUfGlc
hkxzxzuTuTuTuTuTuTuTxzIJhkMJhkIJpoMcMcMcMccDvUvUvUvUvUvUkhvUvUfGlc
hkxzxzuTuTuTuTuTuTuTxzIJWDWHWHIJgogogojZgojZgogogogogojZgozcgogolc
hkxzxzuTuTuTuTuTuTuTxzIJhkMthkIJxzxzkhYnkhYnkhxzSWxzkhYnkhYnkhxzxz
hkxzxzuTuTuTuTuTuTuTxzIJuTaJuTIJxzxzkhYnkhYnkhSWSWSWkhYnkhYnkhxzxz
hkSWSWSWSWSWSWSWSWSWSWIJuTuTuTIJxzxzkhYnkhYnkhSWxzSWkhYnkhYnkhxzxz
hkxzxzxzxzxzxzxzxzxzxzIJuTuTuTIJxzxzkhYnkhYnkhSWSWSWkhYnkhYnkhxzxz
hkuTuTuTuTuTuTuTuTuTuTxzuTuTuTxzxzxzkhZIkhZIkhxzSWxzkhZIkhwDkhxzxz
hkuTuTuTuTuTuTuTuTuTuTuTuTomuTuTuTuTuTuTuTuTuTuTuTuTuTkluTuTuTuTuT
"}
