//MAP CONVERTED BY dmm2tgm.py THIS HEADER COMMENT PREVENTS RECONVERSION, DO NOT REMOVE
"a" = (
/turf/open/space/basic,
/area/space)
"v" = (
/turf/closed/wall,
/area/space)
"H" = (
/turf/closed/wall/r_wall/rust,
/area/space)

(1,1,1) = {"
a
a
a
a
a
a
a
a
a
a
a
a
a
a
a
a
a
a
a
a
a
a
a
a
a
"}
(2,1,1) = {"
a
a
a
a
a
a
a
a
a
a
a
a
a
a
a
a
a
a
a
a
a
a
a
a
a
"}
(3,1,1) = {"
a
a
a
a
a
a
a
a
a
a
a
a
a
a
a
a
a
a
a
a
a
a
a
a
a
"}
(4,1,1) = {"
a
a
a
a
a
a
a
a
a
a
a
a
a
a
a
a
a
a
a
a
a
a
a
a
a
"}
(5,1,1) = {"
a
a
a
a
a
a
a
a
a
a
a
a
a
a
a
a
a
a
a
a
a
a
a
a
a
"}
(6,1,1) = {"
a
a
a
a
a
a
a
a
a
a
a
a
a
a
a
a
a
a
a
a
a
a
a
a
a
"}
(7,1,1) = {"
a
a
a
a
a
a
a
a
a
a
a
a
a
a
a
a
a
a
a
a
a
a
a
a
a
"}
(8,1,1) = {"
a
a
a
a
a
a
a
a
a
a
a
a
a
a
a
a
a
a
a
a
a
a
a
a
a
"}
(9,1,1) = {"
a
a
a
a
a
a
a
a
a
a
a
a
a
a
a
a
a
a
a
a
a
a
a
a
a
"}
(10,1,1) = {"
a
a
a
a
a
a
a
a
a
a
a
a
a
a
a
a
a
a
a
a
a
a
a
a
v
"}
(11,1,1) = {"
a
a
a
a
a
a
a
a
a
a
a
a
a
a
a
a
a
a
a
a
a
a
a
a
v
"}
(12,1,1) = {"
a
a
a
a
a
a
a
a
a
a
a
a
a
a
a
a
a
a
a
a
a
a
a
a
v
"}
(13,1,1) = {"
a
a
a
a
a
a
a
a
a
a
a
a
a
a
a
a
a
a
a
a
a
a
a
a
v
"}
(14,1,1) = {"
a
a
a
a
a
a
a
a
a
a
a
a
a
a
a
a
a
a
a
a
a
a
a
a
v
"}
(15,1,1) = {"
a
a
a
a
a
a
a
a
a
a
a
a
a
a
a
a
a
a
a
a
a
a
a
a
v
"}
(16,1,1) = {"
a
a
a
a
a
a
a
a
a
a
a
a
a
a
a
a
a
a
a
a
a
H
H
H
H
"}
(17,1,1) = {"
a
a
a
a
a
a
a
a
a
a
a
a
a
a
a
a
a
a
a
a
a
a
a
a
v
"}
(18,1,1) = {"
a
a
a
a
a
a
a
a
a
a
a
a
a
a
a
a
a
a
a
a
a
a
a
a
v
"}
(19,1,1) = {"
a
a
a
a
a
a
a
a
a
a
a
a
a
a
a
a
a
a
a
a
a
a
a
a
v
"}
(20,1,1) = {"
H
a
a
a
a
a
a
a
a
a
a
a
a
a
a
a
a
a
a
a
a
a
a
a
v
"}
(21,1,1) = {"
v
a
a
a
a
a
a
a
a
a
a
a
a
a
a
a
a
a
a
a
a
a
a
a
v
"}
(22,1,1) = {"
v
a
a
a
a
a
a
a
a
a
a
a
a
a
a
a
a
a
a
a
a
a
a
a
v
"}
(23,1,1) = {"
v
a
a
a
a
a
a
a
a
a
a
a
a
a
a
a
a
a
a
a
a
a
a
a
v
"}
(24,1,1) = {"
v
a
a
a
a
a
a
a
a
a
a
a
a
a
a
a
a
a
a
a
a
a
a
a
v
"}
(25,1,1) = {"
v
a
a
a
a
a
a
a
a
a
a
a
a
a
a
a
a
a
a
a
a
a
a
a
v
"}
(26,1,1) = {"
v
a
a
a
a
a
a
v
v
v
v
a
a
v
a
a
a
a
a
a
a
a
a
a
v
"}
(27,1,1) = {"
v
a
a
a
a
a
a
v
a
a
v
a
a
v
a
a
a
a
a
a
a
a
a
a
v
"}
(28,1,1) = {"
v
a
a
a
a
a
a
v
a
a
v
a
a
v
a
a
a
a
a
a
a
a
a
a
v
"}
(29,1,1) = {"
v
a
a
a
a
a
a
v
a
a
v
a
a
v
a
a
a
a
a
a
a
a
a
a
v
"}
(30,1,1) = {"
v
a
a
a
a
a
a
v
a
a
v
a
a
v
a
a
a
a
a
a
a
a
a
a
v
"}
(31,1,1) = {"
v
a
a
a
a
a
a
v
a
a
v
a
a
v
a
a
a
a
a
a
a
a
a
a
v
"}
(32,1,1) = {"
v
a
a
a
a
a
a
v
a
a
v
v
v
v
a
a
a
a
a
a
a
a
a
a
v
"}
(33,1,1) = {"
v
a
a
a
a
a
a
a
a
a
a
a
a
a
a
a
a
a
a
a
a
a
a
a
v
"}
(34,1,1) = {"
v
a
a
a
a
a
a
v
v
v
v
v
v
v
a
a
a
a
a
a
a
a
a
a
v
"}
(35,1,1) = {"
v
a
a
a
a
a
a
v
a
a
v
a
a
v
a
a
a
a
a
a
a
a
a
a
v
"}
(36,1,1) = {"
v
a
a
a
a
a
a
v
a
a
v
a
a
v
a
a
a
a
a
a
a
a
a
a
v
"}
(37,1,1) = {"
v
a
a
a
a
a
a
v
a
a
v
a
a
v
a
a
a
a
a
a
a
a
a
a
v
"}
(38,1,1) = {"
v
a
a
a
a
a
a
v
a
a
v
a
a
v
a
a
a
a
a
a
a
a
a
a
v
"}
(39,1,1) = {"
v
a
a
a
a
a
a
a
a
a
a
a
a
a
a
a
a
a
a
a
a
a
a
a
v
"}
(40,1,1) = {"
v
a
a
a
a
a
a
v
v
v
v
v
v
v
a
a
a
a
a
a
a
a
a
a
v
"}
(41,1,1) = {"
v
a
a
a
a
a
a
v
a
a
a
a
a
v
a
a
a
a
a
a
a
a
a
a
v
"}
(42,1,1) = {"
v
a
a
a
a
a
a
v
a
a
a
a
a
v
a
a
a
a
a
a
a
a
a
a
v
"}
(43,1,1) = {"
v
a
a
a
a
a
a
v
a
a
a
a
a
v
a
a
a
a
a
a
a
a
a
a
v
"}
(44,1,1) = {"
v
a
a
a
a
a
a
v
a
a
a
a
a
v
a
a
a
a
a
a
a
a
a
a
v
"}
(45,1,1) = {"
v
a
a
a
a
a
a
a
a
a
a
a
a
a
a
a
a
a
a
a
a
a
a
a
v
"}
(46,1,1) = {"
v
a
a
a
a
a
a
a
a
a
a
a
a
a
a
a
a
a
a
a
a
a
a
a
v
"}
(47,1,1) = {"
v
a
a
a
a
a
a
a
a
a
a
a
a
a
a
a
a
a
a
a
a
a
a
a
v
"}
(48,1,1) = {"
v
a
a
a
a
a
a
a
a
a
a
a
a
a
a
a
a
a
a
a
a
a
a
a
v
"}
(49,1,1) = {"
v
a
a
a
a
a
a
a
a
a
a
a
a
a
a
a
a
a
a
a
a
a
a
a
v
"}
(50,1,1) = {"
v
v
v
v
v
v
v
v
v
v
v
v
v
v
v
v
v
v
v
v
v
v
v
v
v
"}
