//MAP CONVERTED BY dmm2tgm.py THIS HEADER COMMENT PREVENTS RECONVERSION, DO NOT REMOVE
"a" = (
/obj/machinery/atmospherics/pipe/simple/scrubbers/hidden/layer1,
/turf/open/floor/plasteel,
/area/crew_quarters/dorms)
"b" = (
/turf/closed/wall,
/area/crew_quarters/dorms)
"c" = (
/obj/machinery/cryopod{
	dir = 1
	},
/obj/machinery/atmospherics/pipe/simple/scrubbers/hidden/layer1{
	dir = 4
	},
/turf/open/floor/plasteel,
/area/crew_quarters/dorms)
"d" = (
/obj/machinery/atmospherics/pipe/simple/scrubbers/hidden/layer1,
/obj/machinery/atmospherics/pipe/simple/supply/hidden/layer3,
/turf/open/floor/plasteel,
/area/crew_quarters/dorms)
"e" = (
/obj/machinery/door/airlock{
	id_tag = "Dorm2";
	name = "Room One"
	},
/obj/machinery/atmospherics/pipe/simple/supply/hidden/layer3{
	dir = 8
	},
/turf/open/floor/carpet,
/area/crew_quarters/dorms)
"h" = (
/obj/machinery/button/door{
	id = "Dorm5";
	name = "Cabin Bolt Control";
	normaldoorcontrol = 1;
	pixel_x = 25;
	specialfunctions = 4
	},
/turf/open/floor/carpet,
/area/crew_quarters/dorms)
"i" = (
/obj/machinery/cryopod{
	dir = 1
	},
/obj/machinery/atmospherics/pipe/simple/scrubbers/hidden/layer1{
	dir = 4
	},
/turf/open/floor/plasteel,
/area/crew_quarters/dorms)
"j" = (
/obj/machinery/atmospherics/pipe/simple/scrubbers/hidden/layer1{
	dir = 4
	},
/turf/closed/wall,
/area/crew_quarters/dorms)
"k" = (
/obj/machinery/door/airlock{
	id_tag = "Dorm3";
	name = "Room Two"
	},
/obj/machinery/atmospherics/pipe/simple/supply/hidden/layer3{
	dir = 8
	},
/turf/open/floor/carpet,
/area/crew_quarters/dorms)
"l" = (
/obj/machinery/button/door{
	id = "Dorm2";
	name = "Dorm Bolt Control";
	normaldoorcontrol = 1;
	pixel_x = -25;
	specialfunctions = 4
	},
/turf/open/floor/carpet,
/area/crew_quarters/dorms)
"m" = (
/obj/machinery/atmospherics/pipe/manifold4w/scrubbers/hidden/layer1,
/obj/machinery/atmospherics/pipe/simple/supply/hidden/layer3,
/turf/open/floor/plasteel,
/area/crew_quarters/dorms)
"o" = (
/obj/machinery/atmospherics/pipe/simple/supply/hidden/layer3{
	dir = 8
	},
/turf/open/floor/plasteel,
/area/crew_quarters/dorms)
"p" = (
/obj/effect/spawner/structure/window,
/obj/machinery/atmospherics/pipe/simple/scrubbers/hidden/layer1{
	dir = 4
	},
/obj/machinery/atmospherics/pipe/simple/supply/hidden/layer3{
	dir = 8
	},
/turf/open/floor/plating,
/area/crew_quarters/dorms)
"q" = (
/obj/machinery/door/airlock{
	id_tag = "Dorm6";
	name = "Room Five"
	},
/obj/machinery/atmospherics/pipe/simple/supply/hidden/layer3{
	dir = 8
	},
/turf/open/floor/carpet,
/area/crew_quarters/dorms)
"r" = (
/obj/machinery/atmospherics/pipe/simple/scrubbers/hidden/layer1{
	dir = 4
	},
/obj/machinery/atmospherics/pipe/simple/supply/hidden/layer3{
	dir = 8
	},
/turf/open/floor/plasteel,
/area/crew_quarters/dorms)
"s" = (
/obj/machinery/atmospherics/pipe/manifold/scrubbers/hidden/layer1{
	dir = 8
	},
/obj/machinery/atmospherics/pipe/simple/supply/hidden/layer3,
/turf/open/floor/plasteel,
/area/crew_quarters/dorms)
"t" = (
/obj/machinery/atmospherics/pipe/simple/scrubbers/hidden/layer1,
/obj/machinery/atmospherics/pipe/manifold/supply/hidden/layer3,
/turf/open/floor/plasteel,
/area/crew_quarters/dorms)
"u" = (
/obj/machinery/door/airlock{
	id_tag = "Dorm5";
	name = "Room Four"
	},
/obj/machinery/atmospherics/pipe/simple/supply/hidden/layer3{
	dir = 8
	},
/turf/open/floor/carpet,
/area/crew_quarters/dorms)
"w" = (
/obj/machinery/door/airlock/public/glass{
	name = "Dormitory"
	},
/turf/open/floor/plasteel,
/area/crew_quarters/dorms)
"x" = (
/obj/machinery/atmospherics/pipe/simple/supply/hidden/layer3{
	dir = 8
	},
/turf/open/floor/plasteel,
/area/crew_quarters/dorms)
"A" = (
/obj/machinery/atmospherics/pipe/simple/scrubbers/hidden/layer1{
	dir = 10
	},
/obj/machinery/atmospherics/pipe/manifold/supply/hidden/layer3{
	dir = 4
	},
/turf/open/floor/plasteel,
/area/crew_quarters/dorms)
"B" = (
/obj/structure/bed,
/obj/machinery/atmospherics/components/unary/vent_scrubber/on/layer1{
	dir = 8
	},
/turf/open/floor/carpet,
/area/crew_quarters/dorms)
"C" = (
/obj/structure/bed,
/obj/machinery/atmospherics/components/unary/vent_scrubber/on/layer1{
	dir = 4
	},
/turf/open/floor/carpet,
/area/crew_quarters/dorms)
"D" = (
/obj/machinery/cryopod{
	dir = 1
	},
/obj/machinery/atmospherics/pipe/manifold/scrubbers/hidden/layer1,
/turf/open/floor/plasteel,
/area/crew_quarters/dorms)
"E" = (
/obj/machinery/button/door{
	id = "Dorm4";
	name = "Dorm Bolt Control";
	normaldoorcontrol = 1;
	pixel_x = 25;
	specialfunctions = 4
	},
/turf/open/floor/carpet,
/area/crew_quarters/dorms)
"F" = (
/obj/machinery/light/small{
	dir = 1
	},
/obj/machinery/atmospherics/components/unary/vent_pump/on/layer3{
	dir = 4
	},
/turf/open/floor/carpet,
/area/crew_quarters/dorms)
"G" = (
/obj/structure/closet/secure_closet/personal,
/obj/machinery/atmospherics/pipe/simple/scrubbers/hidden/layer1{
	dir = 4
	},
/turf/open/floor/carpet,
/area/crew_quarters/dorms)
"I" = (
/obj/machinery/atmospherics/pipe/simple/scrubbers/hidden/layer1,
/obj/machinery/atmospherics/pipe/manifold4w/supply/hidden/layer3,
/turf/open/floor/plasteel,
/area/crew_quarters/dorms)
"J" = (
/obj/machinery/airalarm{
	pixel_y = 23
	},
/obj/machinery/atmospherics/pipe/simple/supply/hidden/layer3{
	dir = 8
	},
/turf/open/floor/carpet,
/area/crew_quarters/dorms)
"K" = (
/obj/machinery/button/door{
	id = "Room One";
	name = "Door Bolt Control";
	normaldoorcontrol = 1;
	pixel_x = -25;
	specialfunctions = 4
	},
/turf/open/floor/carpet,
/area/crew_quarters/dorms)
"L" = (
/obj/machinery/atmospherics/pipe/simple/scrubbers/hidden/layer1{
	dir = 4
	},
/turf/open/floor/plasteel,
/area/crew_quarters/dorms)
"M" = (
/obj/machinery/atmospherics/pipe/simple/scrubbers/hidden/layer1{
	dir = 4
	},
/turf/open/floor/plasteel,
/area/crew_quarters/dorms)
"N" = (
/obj/machinery/light/small{
	dir = 1
	},
/obj/machinery/atmospherics/components/unary/vent_pump/on/layer3{
	dir = 8
	},
/turf/open/floor/carpet,
/area/crew_quarters/dorms)
"P" = (
/obj/machinery/atmospherics/pipe/simple/scrubbers/hidden/layer1{
	dir = 4
	},
/turf/open/floor/plasteel,
/area/crew_quarters/dorms)
"Q" = (
/obj/machinery/door/airlock{
	id_tag = "Dorm4";
	name = "Room Three"
	},
/obj/machinery/atmospherics/pipe/simple/supply/hidden/layer3{
	dir = 8
	},
/turf/open/floor/carpet,
/area/crew_quarters/dorms)
"R" = (
/obj/machinery/door/airlock/public/glass{
	name = "Dormitory"
	},
/turf/open/floor/plasteel,
/area/crew_quarters/dorms)
"S" = (
/obj/machinery/airalarm{
	pixel_y = 23
	},
/obj/machinery/vr_sleeper,
/turf/open/floor/plasteel,
/area/crew_quarters/dorms)
"V" = (
/obj/machinery/button/door{
	id = "Dorm3";
	name = "Dorm Bolt Control";
	normaldoorcontrol = 1;
	pixel_x = -25;
	specialfunctions = 4
	},
/turf/open/floor/carpet,
/area/crew_quarters/dorms)
"X" = (
/obj/machinery/vr_sleeper,
/obj/machinery/atmospherics/pipe/simple/supply/hidden/layer3{
	dir = 6
	},
/turf/open/floor/plasteel,
/area/crew_quarters/dorms)
"Y" = (
/turf/open/floor/carpet,
/area/crew_quarters/dorms)
"Z" = (
/turf/open/floor/plasteel,
/area/crew_quarters/dorms)

(1,1,1) = {"
b
R
p
R
b
b
b
b
b
b
b
b
"}
(2,1,1) = {"
b
Z
r
Z
b
F
Y
C
b
F
Y
C
"}
(3,1,1) = {"
b
Z
r
Z
b
J
h
G
b
J
E
G
"}
(4,1,1) = {"
b
Z
r
Z
b
u
b
j
b
q
b
j
"}
(5,1,1) = {"
b
Z
r
Z
Z
x
Z
P
Z
x
Z
i
"}
(6,1,1) = {"
b
S
r
Z
Z
x
Z
P
Z
x
Z
i
"}
(7,1,1) = {"
b
X
A
s
d
I
d
m
d
t
a
D
"}
(8,1,1) = {"
b
x
Z
P
Z
x
Z
P
Z
x
Z
i
"}
(9,1,1) = {"
b
e
b
j
b
k
b
j
b
Q
b
j
"}
(10,1,1) = {"
b
J
K
G
b
J
l
G
b
J
V
G
"}
(11,1,1) = {"
b
N
Y
B
b
N
Y
B
b
N
Y
B
"}
(12,1,1) = {"
b
b
b
b
b
b
b
b
b
b
b
b
"}
