//MAP CONVERTED BY dmm2tgm.py THIS HEADER COMMENT PREVENTS RECONVERSION, DO NOT REMOVE
"b" = (
/turf/closed/wall,
/area/space)
"x" = (
/turf/open/space/basic,
/area/space)

(1,1,1) = {"
b
b
b
b
b
b
b
b
b
b
b
b
"}
(2,1,1) = {"
b
x
x
x
x
x
x
x
x
x
x
b
"}
(3,1,1) = {"
b
x
x
x
x
x
x
x
x
x
x
b
"}
(4,1,1) = {"
b
x
x
b
b
b
b
b
b
x
x
b
"}
(5,1,1) = {"
b
x
x
b
x
x
x
x
b
x
x
b
"}
(6,1,1) = {"
b
x
x
b
x
x
x
x
b
x
x
b
"}
(7,1,1) = {"
b
x
x
x
b
b
b
b
x
x
x
b
"}
(8,1,1) = {"
b
x
x
x
x
x
x
x
x
x
x
b
"}
(9,1,1) = {"
b
x
x
x
x
x
x
x
x
x
x
b
"}
(10,1,1) = {"
b
x
x
x
x
x
x
x
x
x
x
b
"}
(11,1,1) = {"
b
x
x
x
x
x
x
x
x
x
x
b
"}
(12,1,1) = {"
b
b
b
b
b
b
b
b
b
b
b
b
"}
