//MAP CONVERTED BY dmm2tgm.py THIS HEADER COMMENT PREVENTS RECONVERSION, DO NOT REMOVE
"aY" = (
/obj/machinery/atmospherics/components/unary/vent_pump/on{
	dir = 1
	},
/turf/open/floor/plasteel,
/area/tcommsat/computer)
"bY" = (
/obj/machinery/computer/telecomms/server,
/turf/open/floor/plasteel,
/area/tcommsat/computer)
"cB" = (
/obj/structure/table,
/obj/item/multitool,
/turf/open/floor/plasteel,
/area/tcommsat/computer)
"cF" = (
/obj/machinery/telecomms/server/presets/command,
/turf/open/floor/plasteel/dark/telecomms,
/area/tcommsat/server)
"eZ" = (
/turf/closed/wall/r_wall,
/area/tcommsat/computer)
"fa" = (
/obj/structure/table,
/turf/open/floor/plasteel,
/area/tcommsat/computer)
"hv" = (
/obj/machinery/door/airlock/engineering/glass{
	name = "Server Room";
	req_access_txt = "61"
	},
/obj/effect/mapping_helpers/airlock/cyclelink_helper{
	dir = 1
	},
/obj/machinery/atmospherics/pipe/simple/supply/hidden{
	dir = 4
	},
/turf/open/floor/plasteel,
/area/tcommsat/computer)
"ib" = (
/obj/machinery/computer/message_monitor,
/turf/open/floor/plasteel,
/area/tcommsat/computer)
"iE" = (
/obj/machinery/telecomms/server/presets/security,
/turf/open/floor/plasteel/dark/telecomms,
/area/tcommsat/server)
"iG" = (
/obj/effect/spawner/structure/window/reinforced,
/obj/structure/cable{
	icon_state = "1-8"
	},
/obj/structure/cable{
	icon_state = "0-8"
	},
/turf/open/floor/plating,
/area/tcommsat/server)
"iO" = (
/obj/machinery/announcement_system,
/turf/open/floor/plasteel,
/area/tcommsat/computer)
"iP" = (
/obj/structure/cable{
	icon_state = "1-2"
	},
/turf/open/floor/plasteel/dark/telecomms,
/area/tcommsat/server)
"jL" = (
/obj/machinery/atmospherics/pipe/manifold/supply/hidden,
/turf/open/floor/plasteel,
/area/tcommsat/computer)
"jW" = (
/obj/effect/spawner/structure/window/reinforced,
/obj/structure/cable,
/turf/open/floor/plating,
/area/tcommsat/computer)
"kl" = (
/obj/machinery/telecomms/hub/preset,
/turf/open/floor/circuit/telecomms/mainframe,
/area/tcommsat/server)
"lm" = (
/obj/structure/cable{
	icon_state = "0-4"
	},
/obj/machinery/power/smes{
	charge = 2e+006
	},
/turf/open/floor/circuit/telecomms/mainframe,
/area/tcommsat/server)
"mm" = (
/obj/structure/cable{
	icon_state = "1-2"
	},
/turf/open/floor/circuit/telecomms/mainframe,
/area/tcommsat/server)
"mz" = (
/obj/machinery/telecomms/server/presets/service,
/turf/open/floor/plasteel/dark/telecomms,
/area/tcommsat/server)
"nW" = (
/obj/machinery/atmospherics/pipe/simple/supply/hidden{
	dir = 4
	},
/turf/closed/wall/r_wall,
/area/tcommsat/computer)
"oC" = (
/turf/open/floor/circuit/telecomms/mainframe,
/area/tcommsat/server)
"pK" = (
/obj/machinery/power/terminal{
	dir = 4
	},
/turf/open/floor/circuit/telecomms/mainframe,
/area/tcommsat/server)
"pW" = (
/obj/machinery/atmospherics/components/unary/vent_pump/on{
	dir = 8
	},
/turf/open/floor/plasteel,
/area/tcommsat/computer)
"rs" = (
/obj/effect/spawner/structure/window/reinforced,
/obj/structure/cable{
	icon_state = "0-4"
	},
/obj/structure/cable{
	icon_state = "4-8"
	},
/obj/structure/cable{
	icon_state = "2-4"
	},
/turf/open/floor/plating,
/area/tcommsat/server)
"sv" = (
/obj/machinery/atmospherics/pipe/simple/supply/hidden{
	dir = 10
	},
/turf/open/floor/plasteel,
/area/tcommsat/computer)
"sZ" = (
/obj/machinery/telecomms/processor/preset_four,
/turf/open/floor/circuit/telecomms/mainframe,
/area/tcommsat/server)
"tR" = (
/obj/machinery/door/airlock/command/glass{
	name = "Control Room";
	req_access_txt = "19; 61"
	},
/turf/open/floor/plasteel,
/area/tcommsat/computer)
"uU" = (
/obj/machinery/atmospherics/components/unary/vent_scrubber/on,
/turf/open/floor/plasteel,
/area/tcommsat/computer)
"zj" = (
/obj/machinery/computer/telecomms/monitor,
/turf/open/floor/plasteel,
/area/tcommsat/computer)
"zF" = (
/obj/machinery/door/airlock/engineering{
	name = "Telecommunications";
	req_access_txt = "61"
	},
/turf/open/floor/plasteel,
/area/tcommsat/computer)
"AE" = (
/obj/machinery/telecomms/server/presets/supply,
/turf/open/floor/plasteel/dark/telecomms,
/area/tcommsat/server)
"CS" = (
/obj/effect/spawner/structure/window/reinforced,
/obj/structure/cable{
	icon_state = "0-4"
	},
/obj/structure/cable{
	icon_state = "4-8"
	},
/turf/open/floor/plating,
/area/tcommsat/server)
"Db" = (
/obj/machinery/atmospherics/components/unary/vent_scrubber/on{
	dir = 8
	},
/turf/open/floor/plasteel,
/area/tcommsat/computer)
"Fg" = (
/turf/closed/wall/r_wall,
/area/tcommsat/server)
"Hd" = (
/obj/structure/cable{
	icon_state = "4-8"
	},
/obj/structure/cable{
	icon_state = "2-8"
	},
/turf/open/floor/circuit/telecomms/mainframe,
/area/tcommsat/server)
"If" = (
/obj/machinery/power/apc/highcap/five_k{
	areastring = "/area/tcommsat/server";
	dir = 4;
	name = "Telecomms Server APC";
	pixel_x = 25
	},
/obj/structure/cable{
	icon_state = "0-8"
	},
/obj/machinery/power/terminal{
	dir = 4
	},
/turf/open/floor/circuit/telecomms/mainframe,
/area/tcommsat/server)
"Jd" = (
/obj/machinery/telecomms/server/presets/engineering,
/turf/open/floor/plasteel/dark/telecomms,
/area/tcommsat/server)
"KQ" = (
/obj/effect/spawner/structure/window/reinforced,
/obj/machinery/atmospherics/pipe/simple/scrubbers/hidden{
	dir = 4
	},
/turf/open/floor/plasteel,
/area/tcommsat/computer)
"Lz" = (
/obj/machinery/telecomms/message_server,
/turf/open/floor/plasteel/dark/telecomms,
/area/tcommsat/server)
"LE" = (
/obj/machinery/ntnet_relay,
/turf/open/floor/plasteel/dark/telecomms,
/area/tcommsat/server)
"Mo" = (
/obj/machinery/atmospherics/pipe/simple/supply/hidden{
	dir = 4
	},
/turf/closed/wall,
/area/tcommsat/computer)
"MB" = (
/obj/structure/table,
/obj/item/radio/off,
/turf/open/floor/plasteel,
/area/tcommsat/computer)
"MP" = (
/obj/effect/spawner/structure/window/reinforced,
/obj/structure/cable{
	icon_state = "0-4"
	},
/turf/open/floor/plating,
/area/tcommsat/server)
"NL" = (
/obj/machinery/atmospherics/pipe/manifold/scrubbers/hidden,
/turf/open/floor/plasteel,
/area/tcommsat/computer)
"NN" = (
/obj/machinery/requests_console{
	announcementConsole = 1;
	department = "Telecomms Admin";
	departmentType = 5;
	name = "Telecomms RC";
	pixel_x = 30
	},
/obj/machinery/atmospherics/pipe/simple/scrubbers/hidden{
	dir = 4
	},
/turf/open/floor/plasteel,
/area/tcommsat/computer)
"NV" = (
/obj/structure/closet/emcloset,
/obj/machinery/atmospherics/pipe/simple/scrubbers/hidden{
	dir = 4
	},
/turf/open/floor/plasteel,
/area/tcommsat/computer)
"Ot" = (
/obj/machinery/atmospherics/pipe/simple/supply/hidden{
	dir = 6
	},
/turf/open/floor/plasteel,
/area/tcommsat/computer)
"Pg" = (
/obj/machinery/atmospherics/pipe/simple/supply/hidden{
	dir = 4
	},
/turf/open/floor/plasteel,
/area/tcommsat/computer)
"Ps" = (
/obj/machinery/telecomms/receiver/preset_right,
/turf/open/floor/plasteel/dark/telecomms,
/area/tcommsat/server)
"PM" = (
/obj/machinery/telecomms/server/presets/medical,
/turf/open/floor/plasteel/dark/telecomms,
/area/tcommsat/server)
"PU" = (
/obj/machinery/door/airlock/engineering/glass{
	name = "Server Room";
	req_access_txt = "61"
	},
/obj/effect/mapping_helpers/airlock/cyclelink_helper,
/obj/structure/cable{
	icon_state = "4-8"
	},
/turf/open/floor/plasteel,
/area/tcommsat/server)
"QO" = (
/obj/machinery/atmospherics/pipe/simple/scrubbers/hidden{
	dir = 4
	},
/turf/open/floor/plasteel,
/area/tcommsat/computer)
"Rb" = (
/turf/open/floor/plasteel/dark/telecomms,
/area/tcommsat/server)
"RO" = (
/obj/machinery/telecomms/server/presets/science,
/turf/open/floor/plasteel/dark/telecomms,
/area/tcommsat/server)
"RP" = (
/obj/machinery/atmospherics/pipe/simple/scrubbers/hidden{
	dir = 4
	},
/turf/closed/wall/r_wall,
/area/tcommsat/computer)
"SL" = (
/obj/machinery/telecomms/broadcaster/preset_right,
/turf/open/floor/plasteel/dark/telecomms,
/area/tcommsat/server)
"TQ" = (
/obj/effect/spawner/structure/window/reinforced,
/turf/open/floor/plasteel,
/area/tcommsat/computer)
"Wb" = (
/obj/machinery/telecomms/bus/preset_three,
/turf/open/floor/circuit/telecomms/mainframe,
/area/tcommsat/server)
"Xl" = (
/obj/machinery/telecomms/server/presets/common,
/turf/open/floor/plasteel/dark/telecomms,
/area/tcommsat/server)
"Yw" = (
/turf/open/floor/plasteel,
/area/tcommsat/computer)
"ZW" = (
/obj/machinery/holopad,
/turf/open/floor/plasteel,
/area/tcommsat/computer)

(1,1,1) = {"
Fg
Fg
Fg
Fg
Fg
Fg
Fg
Fg
Fg
Fg
Fg
eZ
eZ
nW
zF
RP
eZ
"}
(2,1,1) = {"
Fg
Jd
Rb
Rb
Rb
oC
Rb
Rb
Rb
Rb
Fg
MB
Ot
jL
Yw
QO
eZ
"}
(3,1,1) = {"
Fg
Xl
oC
oC
oC
oC
oC
oC
oC
Rb
MP
zj
Pg
pW
uU
NL
eZ
"}
(4,1,1) = {"
Fg
iE
oC
SL
Rb
oC
Rb
Ps
oC
Rb
CS
cB
Pg
Yw
Yw
NN
eZ
"}
(5,1,1) = {"
Fg
cF
oC
Rb
oC
oC
oC
Rb
oC
Rb
rs
jW
Mo
ZW
Yw
QO
eZ
"}
(6,1,1) = {"
Fg
oC
oC
sZ
oC
kl
oC
Wb
oC
oC
PU
Yw
hv
Yw
Yw
NV
eZ
"}
(7,1,1) = {"
Fg
AE
oC
Rb
oC
pK
oC
Rb
oC
Rb
rs
jW
Mo
TQ
tR
KQ
eZ
"}
(8,1,1) = {"
Fg
mz
oC
LE
Rb
lm
Rb
Lz
oC
Rb
CS
bY
sv
aY
Yw
Db
eZ
"}
(9,1,1) = {"
Fg
PM
oC
oC
oC
Hd
mm
mm
mm
iP
iG
ib
Yw
Yw
Yw
Yw
eZ
"}
(10,1,1) = {"
Fg
RO
Rb
Rb
Rb
If
Rb
Rb
Rb
Rb
Fg
iO
Yw
fa
fa
fa
eZ
"}
(11,1,1) = {"
Fg
Fg
Fg
Fg
Fg
Fg
Fg
Fg
Fg
Fg
Fg
eZ
eZ
eZ
eZ
eZ
eZ
"}
